111111111111111111111111
100000000000000001000001
100W00001000000000000001
1000000C000E000010000001
1000000000000W0010000001
110000000011111100000001
100000000000000000000001
1000000000000W0000000001
100000000000000000001001
100P000000000W0000000001
111111111111111111111111